8.ox
...........o
............
o.o.......o.
oo..........
............
............
.......o....
......o..oo.
